9,9,9,9,9,9,9,9,9,9,9,9,9,9,9,9,9,9,9,9,9,9,9,9,9,9,9,9,9,9,9,9,9,9,9,9,9,9,9,9,9,9,9,9,9,9,9,9,9,9,9,9,9,9,9,9,9,9,9,9,
9,9,9,9,9,9,9,9,9,9,9,9,9,9,9,9,9,9,9,9,9,9,9,9,9,9,2,2,9,9,9,9,9,9,9,9,9,9,9,9,9,9,9,9,9,9,9,9,9,9,9,9,9,9,9,9,9,9,9,9,
9,9,9,9,9,9,9,9,9,9,9,9,9,9,9,9,9,9,9,9,9,9,9,9,9,9,9,9,9,2,2,9,9,9,9,9,9,9,9,9,9,9,9,9,9,9,9,9,9,9,9,9,9,9,9,9,9,9,9,9,
3,3,3,7,7,7,7,7,7,7,7,7,7,7,7,7,7,7,7,7,7,7,7,7,7,7,7,7,7,7,7,7,7,7,7,7,7,7,7,7,7,7,7,7,7,7,7,7,7,7,7,7,7,3,3,3,3,3,3,3,
9,9,9,9,9,9,3,1,1,1,1,1,1,1,1,1,1,1,1,1,1,1,1,1,1,1,1,1,1,1,1,1,1,1,1,1,1,1,1,1,1,1,1,1,1,1,1,1,1,1,1,1,1,3,3,3,3,3,3,3,
9,9,9,9,9,9,3,1,1,1,1,1,1,1,1,1,1,1,1,1,1,1,1,1,1,1,1,1,1,1,1,1,1,1,1,1,1,1,1,1,1,1,1,1,1,1,1,1,1,1,1,1,1,3,3,3,3,3,3,3,
9,9,9,9,9,9,3,1,1,1,1,1,1,1,1,1,1,1,1,1,1,1,1,1,1,1,1,1,1,1,1,1,1,1,1,1,1,1,1,1,1,1,1,1,1,1,1,1,1,1,1,1,1,3,3,3,3,3,3,3,
9,9,9,9,9,9,3,1,1,1,1,1,1,1,1,1,1,1,1,1,1,1,1,1,1,1,1,1,1,1,1,1,1,1,1,1,1,1,1,1,1,1,1,1,1,1,1,1,1,1,1,1,1,3,3,3,3,3,3,3,
9,9,9,9,9,9,3,1,1,1,1,1,1,1,1,1,1,1,1,1,1,1,1,1,1,1,1,1,1,1,1,1,1,1,1,1,1,1,1,1,1,1,1,1,1,1,1,1,1,1,1,1,1,3,3,3,3,3,3,3,
9,9,9,9,9,9,3,1,1,1,1,1,1,1,1,1,1,1,1,1,1,1,1,1,1,1,1,1,1,1,1,1,1,1,1,1,1,1,1,1,1,1,1,1,1,1,1,1,1,1,1,1,1,3,3,3,3,3,3,3,
9,9,9,9,9,9,3,1,1,1,1,1,1,1,1,1,1,1,1,1,1,1,1,1,1,1,1,1,1,1,1,1,1,1,1,1,1,1,1,1,1,1,1,1,1,1,1,1,1,1,1,1,1,3,3,3,3,3,3,3,
9,9,9,9,9,9,3,1,1,1,1,1,1,1,1,1,1,1,1,1,1,1,1,1,1,1,1,1,1,1,1,1,1,1,1,1,1,1,1,1,1,1,1,1,1,1,1,1,1,1,1,1,1,3,3,3,3,3,3,3,
9,9,9,9,9,9,3,1,1,1,1,1,1,1,1,1,1,1,1,1,1,1,1,1,1,1,1,1,1,1,1,1,1,1,1,1,1,1,1,1,1,1,1,1,1,1,1,1,1,1,1,1,1,3,3,3,3,3,3,3,
9,9,9,9,9,9,3,1,1,1,1,1,1,1,1,1,1,1,1,1,1,1,1,1,1,1,1,1,1,1,1,1,1,1,1,1,1,1,1,1,1,1,1,1,1,1,1,1,1,1,1,1,1,3,3,3,3,3,3,3,
9,9,9,9,9,9,3,1,1,1,1,1,1,1,1,1,1,1,1,1,1,1,1,1,8,8,8,8,8,1,8,8,8,8,8,8,8,8,8,1,1,1,1,1,1,1,1,1,1,1,1,1,1,3,3,3,3,3,3,3,
9,9,9,9,9,9,3,3,3,3,3,3,3,3,3,3,3,3,3,3,3,3,3,3,8,8,8,8,8,1,8,8,8,8,8,8,8,8,8,7,3,3,3,3,3,3,3,3,3,3,1,3,3,3,3,3,3,3,3,3,
9,9,9,9,9,9,3,1,1,1,1,1,1,1,1,1,1,1,1,1,1,1,8,9,2,2,2,2,2,2,2,2,2,2,2,2,2,2,8,1,1,1,1,1,1,1,1,1,1,1,1,1,1,3,3,3,3,3,3,3,
9,9,9,9,9,9,3,1,1,1,1,1,1,1,1,1,1,1,1,1,1,1,8,9,2,2,2,2,2,2,2,2,2,2,2,2,2,2,8,1,1,1,1,1,1,1,1,1,1,1,1,1,1,3,3,3,3,3,3,3,
9,9,9,9,9,9,3,1,1,1,1,1,1,1,1,1,1,1,1,1,1,1,8,9,2,2,2,2,2,2,2,2,2,2,2,2,2,2,8,1,1,1,1,1,1,1,1,1,1,1,1,1,1,3,3,3,3,3,3,3,
9,9,9,9,9,9,3,1,1,1,1,1,1,1,1,1,1,1,1,1,1,1,8,9,2,2,2,2,2,2,2,2,2,2,2,2,2,2,8,1,1,1,1,1,1,1,1,1,1,1,1,1,1,3,3,3,3,3,3,3,
9,9,9,9,9,9,3,1,1,1,1,1,1,1,1,1,1,1,1,1,1,1,8,9,2,2,2,2,2,2,2,2,2,2,2,2,2,2,8,1,1,1,1,1,1,1,1,1,1,1,1,1,1,3,3,3,3,3,3,3,
9,9,9,9,9,9,3,1,1,1,1,1,1,1,1,1,1,1,1,1,1,1,8,9,2,2,2,2,2,2,2,2,2,2,2,2,2,2,8,1,1,1,1,1,1,1,1,1,1,1,1,1,1,3,3,3,3,3,3,3,
9,9,9,9,9,9,3,1,1,1,1,1,1,1,1,1,1,1,1,1,1,1,1,2,2,2,2,2,2,2,2,2,2,2,2,2,2,2,8,1,1,1,1,1,1,1,1,1,1,1,1,1,1,3,3,3,3,3,3,3,
9,9,9,9,9,9,3,1,1,1,1,1,1,1,1,1,1,1,1,1,1,1,8,9,2,2,2,2,2,2,2,2,2,2,2,2,2,2,8,1,1,1,1,1,1,1,1,1,1,1,1,1,1,3,3,3,3,3,3,3,
9,9,9,9,9,9,3,1,1,1,1,1,1,1,1,1,1,1,1,1,1,1,8,9,2,2,2,2,2,2,2,2,2,2,2,2,2,2,8,1,1,1,1,1,1,1,1,1,1,1,1,1,1,3,3,3,3,3,3,3,
9,2,9,9,9,9,3,1,1,1,1,1,1,1,1,1,1,1,1,1,1,1,8,9,2,2,2,2,2,2,2,2,2,2,2,2,2,2,8,1,1,1,1,1,1,1,1,1,1,1,1,1,1,3,3,3,3,3,3,3,
9,2,9,9,9,9,3,1,1,1,1,1,1,1,1,1,1,1,1,1,1,1,8,8,2,1,2,2,2,1,1,2,2,2,2,2,1,1,8,1,1,1,1,1,1,1,1,1,1,1,1,1,1,3,3,3,3,3,3,3,
3,3,3,3,3,3,3,1,1,1,1,1,1,1,1,1,1,1,1,1,1,1,8,8,1,1,1,1,1,1,1,1,1,1,1,1,1,1,8,1,1,1,1,1,1,1,1,1,1,1,1,1,1,3,3,3,3,3,3,3,
5,5,5,5,5,5,6,5,5,5,5,5,5,5,5,5,5,5,5,5,5,5,5,5,5,5,5,5,5,5,5,5,5,5,5,5,5,5,5,5,5,5,5,5,5,5,5,5,5,5,5,5,5,6,5,5,5,5,5,5,
5,5,5,5,5,5,6,6,6,6,6,6,6,6,6,6,6,6,6,6,6,6,6,6,6,6,6,6,6,6,6,6,6,6,6,6,6,6,6,6,6,6,6,6,6,6,6,6,6,6,6,6,6,6,5,5,5,5,5,5,
5,5,5,5,5,5,5,5,5,5,5,5,5,5,5,5,5,5,5,5,5,5,5,5,5,5,5,5,5,5,5,5,5,5,5,5,5,5,5,5,5,5,5,5,5,5,5,5,5,5,5,5,5,5,5,5,5,5,5,5,
5,5,5,5,5,5,5,5,5,5,5,5,5,5,5,5,5,5,5,5,5,5,5,5,5,5,5,5,5,5,5,5,5,5,5,5,5,5,5,5,5,5,5,5,5,5,5,5,5,5,5,5,5,5,5,5,5,5,5,5,
5,5,5,5,5,5,5,5,5,5,5,5,5,5,5,5,5,5,5,5,5,5,5,5,5,5,5,5,5,5,5,5,5,5,5,5,5,5,5,5,5,5,5,5,5,5,5,5,5,5,5,5,5,5,5,5,5,5,5,5,
